111111111111111111111
1P000C000CCC00000C001
101100111C1C101011001
101010101C1C101010101
101010111C1C1C1010101
1C10101C1C1C101010101
101100101CC1C01011C01
10C000CC0CCC0000000E1
111111111111111111111
