1111111111111111111111111111
1011111111111111111111111111
1111111111ECP111111111111111
1111111111111111111111111111
1111111111111111111111111111
