111111111111111111111111111111111111111111111111111111111111111111111111111111111111
1E0000000CCC000000000000000000000000000000000000111111100000000011111100000000110001
100000000CCC00000000P000000000000000000000000000000000000000000000000000000000000001
100000000CCC000000000000000000000000000000000000111111100000000011111100000000110001
111111111111111111111111111111111111111111111111111111111111111111111111111111111111
